blue: 0, A
red: 1, B
+++++++++++++
+a        0A+
++++++++ ++++
+++++++++++++
+b        1B+
++++++++ ++++
       +++