+++++++++++++++++++++++++++++++
+a              +++          b+
+++++++++++++++ +++ +++ +++++++
+++++++++++++++ +++ +++ +++++++
+++++++++++++++C+++ +++A+++++++
+0                            +
+                             +
++++++++++++++++++++++++B++++++
++++++++++++++++++++++++ +
++++++++++++++++++++++++c+
++++++++++++++++++++++++++