+++++++++++++++++++++++++
+++   +   +   +   +   +++
+aGGGGGGGGGGGGGGGGGGGGGA+
+GGGGGGGGGGGGGGGGGGGGGG0+
+GGGGGGGGGGGGGGGGGGGGGG +
+GGGGGGGGGGGGGGGGGGGGGG +
+   +   +   +   +   +   +
+++++++++++++++++++++++++
 ++GOOD+LUCK+FORTYTWO+++
  +++++++++++++++++++++