+++++++++++++++++
+                +
+    A           +
+    0A         +
+    A          +
+               +
+   +++++       +
+     aA+       +
+       +       +
+               +
+               +
+               +
+               +
+               +
++              +
 +++++++++++++++
