++++++++++++++++++++
+                Aa+
+               ++++
+                  +
+                  +
+                  +
+                  +
+                  +
+                  +
+                  +
+ 0                +
+                  +
++++++++++++++++++++