blue: 0, A
red: 1, B
green: 2, C
+++++++++++++++++++++++++++++++
+a              +++          b+
+++++++++++++++ +++ +++ +++++++
+++++++++++++++ +++ +++ +++++++
+++++++++++++++C+++ +++A+++++++
+012                          +
+                             +
++++++++++++++++++++++++B++++++
++++++++++++++++++++++++ +
++++++++++++++++++++++++c+
++++++++++++++++++++++++++