++++++++++++++
+            +
+     c      +
+     a      +
+     b      +
+     0      +
++++++++++++++