+++++++++++++++++++++++++
+++  +   +   +   +   ++++
+aGGGGGGGGGGGGGGGGGGGGGA+
+GGGGGGGGGGGGGGGGGGGGGG0+
+GGGGGGGGGGGGGGGGGGGGGG +
+GGGGGGGGGGGGGGGGGGGGGG +
+   +   +   +   +   +   +
+++++++++++++++++++++++++