++++++++
+      +
+  +++ +    
+ ++   +
+  +++ +
+ +BA  +
+ ++++ +
+0 ab+ +
++++++++